okno - okna
pole - pola
muzeum - muzea
dziecko - dzieci
zwierzę - zwierzęta
imię - imiona
cielę - cielęta
nauczycielka - nauczycielki
noga - nogi
powieść - powieści
gęś - gęsi
odpowiedź - odpowiedzi
szmata - szmaty
kołdra - kołdry
królowa - królowy
kasa - kasy
szafa - szafy
rzecz - rzeczy
mysz - muszy
noc - noce
podróż - podróże
babcia - babcie
sesja - sesje
dusza - dusze
pralnia - pralnie
burza - burze
ulica - ulice
sprzedawczyni - sprzedawczynie
mak - maki
róg - rogi
pies - psy
kot - koty
wyraz - wyrazy
koń - konie
liść - liście
koc - koce
krokodyl - krokodyle
struś - strusie
kosz - kosze
klucz - klucze
nóż - noże
żuraw - żurawie
karp - karpie
gołab - gołębie
paw - pawie
jastrząb - jastrzębie
żółw - żółwie
jedwab - jedwabie
student - studenci
sąsiad - sąsiedzi
mnich - mnisi
Francuz - Francuzi
górnik - górnicy
aktor - aktorzy
starzec - starcy
pedagog - pedagodzy
lekarz - lekarze
listonosz - listonosze
nauczyciel - nauczyciele
kibic - kibice
złodziej - złodzieje
gość - goście
Amerykanin - Amerykanie
Rosjanin - Rosjanie
Cygan - Cyganie
syn - synowie
Arab - Arabowie
pan - panowie
król - królowie
profesor - profesorowie
dyrektor - dyrektorowie
reżyser - reżyserowie
geolog - geologowie
burmistrz - burmistrze
rektor - rektorowie
senator - senatorowie
mężczyzna - mężczyźni
dentysta - dentyści
artysta - artyści
rok - lata
człowiek - ludzie
brat - bracia
ksiądz - księża
książę - ksiażęta
ręka - ręce
oko - oczy
ucho - uszy
